-------------------------------
-.............................-                               
-.............................- 
-.DD..........................-
-.DD..........................-
-----------------------++------
-......................++.....-
-......................++.....-
-....P.................++.....-
------------++-----------------
-...........++................-
-...........++................-
-...........++.............P..-
-++----------------------------
-++...........................-
-++...........................-
-++....................P......-
---------------------------++--
-.H........................++.-
-..........................++.-
-..........................++.-
-------------------------------