-------------------------------
-.............................-                               
-.............................- 
-.DD..........................-
-.DD......................O...-
-----------------------++------
-......................++.....-
-......................++.....-
-....P.....O...........++.....-
------------++-----------------
-...........++................-
-...........++................-
-..........O++.............P..-
-++----------------------------
-++...........................-
-++...........................-
-++....................P....O.-
---------------++--------------
-.H............++.............-
-..............++.............-
-..............++.............-
-------------------------------